50 48
0 X X 0 X 0 0 3 4 X 8 0 X 3 2 6 7 0 X 0 4 6 6 0 2 0 0 0 X 0 0 0 0 0 X X 0 7 0 0 X 2 8 0 4 0 X P 
2 2 0 7 3 X 0 4 0 8 X 0 4 8 8 6 8 0 X 0 0 X 6 X 7 5 2 X X X 3 X 0 0 8 3 0 6 0 3 4 X X 8 X 2 5 0 
6 0 4 7 0 0 0 0 0 0 7 X 0 X 6 0 0 0 0 X 0 0 5 0 5 3 0 3 X 3 0 0 X 0 0 X X 0 X 0 8 7 0 0 7 X 7 0 
4 6 6 0 0 X 6 0 0 0 0 8 0 0 8 X 0 0 X 7 0 7 6 0 0 0 3 X 0 0 X 2 2 0 3 X 4 3 4 0 0 0 0 X 6 0 0 6 
0 X 0 0 0 0 0 0 2 7 4 0 0 2 X 0 3 8 0 4 8 5 0 5 X 5 4 2 6 8 0 0 0 X 6 4 0 X X X 7 X X X 6 7 5 0 
X X 8 X 0 3 7 3 0 X 5 0 8 4 0 0 3 0 X 0 0 0 X 0 3 0 X 5 0 3 3 X 0 0 0 0 6 X 6 X 0 0 5 8 2 2 X 0 
0 2 7 X 0 5 0 7 8 X 0 6 3 X 0 7 X 7 0 0 8 7 X X 0 0 2 8 0 0 0 X 0 6 0 0 5 X 0 0 0 5 0 6 0 0 X X 
4 2 X 7 8 4 X 0 7 0 8 0 0 X 0 0 0 6 0 X 0 0 0 0 0 0 0 2 0 6 5 6 0 3 8 2 4 X 0 3 6 5 5 0 0 5 5 5 
4 0 X 6 3 X X 6 7 X X 0 0 0 5 6 0 X 5 0 0 4 2 5 X X 0 0 X 7 0 0 0 0 0 2 0 3 7 X 0 2 X X 6 3 6 0 
0 4 X 0 6 4 0 X 0 7 X 4 0 3 0 X X 0 X 0 2 4 5 X 0 0 X 0 3 X 5 7 5 8 X 0 0 5 0 7 0 X 8 4 6 0 0 4 
X X 0 X 5 7 0 6 8 0 5 8 8 3 8 0 0 6 X 0 5 6 3 0 0 X 4 X 5 X 0 6 X 0 4 0 0 X 0 3 4 X X 8 0 2 0 7 
0 3 3 0 X 0 0 0 X 8 X 3 X 2 0 X 8 7 X 2 0 3 X 6 6 0 7 0 7 X X X X 0 0 6 0 5 6 0 X 0 2 3 X 4 0 0 
2 5 0 X 0 6 X 0 5 0 6 0 3 0 5 X 8 X 3 8 0 2 0 2 X 0 X 7 8 0 7 4 8 X X 2 X X X 0 0 X 3 0 0 0 0 0 
5 4 0 X X 0 7 6 X X 7 6 6 0 3 6 X 4 4 0 X 0 0 0 0 0 2 X 3 5 3 0 0 0 0 2 X 0 0 X 7 0 7 4 4 0 0 6 
8 0 X 0 4 8 0 8 0 X 8 X 0 2 0 X 5 0 8 0 5 2 2 5 6 3 5 0 0 X 5 7 0 2 3 0 2 0 2 0 0 6 4 X 7 0 8 0 
0 0 0 0 3 7 X 0 5 0 0 0 0 X X 0 0 0 6 0 0 0 0 0 0 6 7 7 0 0 X 3 5 X 7 X 0 X 0 0 0 2 0 0 X 3 2 0 
X 0 3 0 5 0 0 0 8 8 X 2 5 7 4 0 0 X 6 5 0 0 0 0 6 0 X 4 0 8 3 3 0 2 X 2 8 8 0 2 X 6 4 6 0 X X 0 
X X 0 0 2 0 0 0 X X 0 0 X X 5 X 0 7 0 0 0 X 3 0 8 7 5 0 0 0 X X X 4 X 0 0 X 3 0 0 X 8 6 3 X X 5 
0 6 0 0 8 X 4 0 0 X 0 4 X 0 0 7 4 8 6 8 0 7 6 0 X 6 0 5 6 4 X 0 3 X 4 X 0 0 0 8 8 7 X X 0 2 0 X 
X 0 0 7 X X X 0 8 X 0 X 0 0 5 0 X 0 X 0 0 0 0 0 0 4 0 7 0 2 4 6 X X 8 0 5 0 4 5 0 7 6 X 6 0 X 0 
8 X 5 6 0 X 0 8 0 0 0 X X 0 0 X 0 3 0 5 6 6 0 0 0 0 X 0 X 0 0 0 3 5 X 0 0 4 0 7 4 5 X 0 3 2 0 0 
8 0 0 3 0 7 0 X 7 X 8 X 0 0 2 3 0 X 2 4 X 0 0 6 X 0 6 0 7 4 2 0 7 7 0 0 X 7 X 0 0 0 0 X 4 5 0 6 
3 X 0 X 6 7 8 0 0 X 0 5 X 0 3 4 0 3 0 4 3 0 4 7 4 X 2 5 0 5 6 3 X 0 7 8 3 0 7 3 0 7 0 0 X 0 0 4 
0 X 0 2 7 2 X 0 2 0 7 7 0 8 X 0 4 0 6 6 0 0 0 X 2 0 8 6 2 X X 8 0 X 0 7 4 0 3 X 3 3 0 0 8 X 0 0 
7 7 0 S 5 0 X 5 X 5 0 0 0 7 3 3 0 0 6 X 0 0 0 4 X 0 8 0 0 0 0 0 X X X 0 3 0 5 0 3 7 3 0 X 4 0 3 
0 0 5 0 7 0 6 4 4 3 X X 5 2 7 2 0 0 8 0 0 3 4 7 0 X 7 0 4 4 0 X 0 7 5 X X 0 2 X 8 0 0 4 X 0 0 X 
0 0 0 X 3 0 4 2 0 0 8 2 0 6 2 5 0 X 2 3 3 0 4 0 6 X 6 0 8 0 0 X X 0 3 0 4 5 3 0 5 7 0 0 X 0 3 2 
X 8 7 0 X 4 5 5 0 5 0 0 0 4 4 6 4 X 6 0 0 X 0 0 0 2 6 5 X 7 0 0 0 0 7 7 6 7 0 0 X 0 0 7 6 X 0 0 
4 8 5 0 5 5 0 0 6 0 0 0 0 2 0 0 X 8 7 0 3 6 3 0 X 5 0 7 0 6 0 0 6 8 0 7 8 8 0 0 0 6 0 0 0 8 6 4 
0 6 X 0 4 0 X 7 3 5 0 6 X 0 4 2 7 X X X X 6 0 X 0 X 0 0 0 6 0 0 0 7 2 0 0 2 2 4 0 X 0 8 6 0 X 0 
0 0 3 0 3 0 0 4 0 X 5 X X 0 X 3 0 0 0 4 4 4 0 X 7 6 0 0 X 6 8 5 5 X X X 0 X 7 0 X 5 0 0 X 8 2 0 
X 5 3 X 3 3 X 2 6 0 0 4 5 0 0 X 4 4 7 0 6 7 0 0 0 3 0 4 0 0 0 4 0 0 X 0 0 0 0 0 0 X 4 0 X X 5 8 
X 8 4 X 4 0 2 0 8 4 8 0 0 X 0 0 0 3 0 X 0 X 6 6 X 0 0 X X 0 0 0 0 4 2 0 X 5 0 0 2 0 4 3 X 3 7 0 
4 0 0 0 X X 3 0 5 2 0 X 0 0 0 X 0 0 7 4 X X 0 3 X 0 0 0 0 0 8 5 0 4 0 0 5 7 0 3 0 0 6 0 0 0 0 0 
0 7 2 5 5 0 0 0 0 0 7 5 X X X 0 0 0 0 0 X X X 5 0 X 3 4 0 2 6 0 4 0 0 6 0 0 7 X 0 X 0 8 0 7 0 3 
3 0 6 0 0 8 0 2 X 8 0 4 X 0 0 3 X X 0 0 0 3 0 X X 0 0 0 2 0 0 X 5 0 3 X 5 0 2 X 2 0 0 X X 0 4 X 
5 3 0 8 0 X 0 8 6 X 4 4 6 0 0 2 0 0 2 5 X 0 2 0 4 7 X 4 4 5 5 X X X X 6 0 4 2 8 X X 0 6 0 X 0 5 
6 4 7 X 0 0 0 3 0 X 0 7 0 5 0 0 7 0 X X 0 0 X 4 0 X X X 5 0 2 0 6 0 X 0 7 2 8 3 8 0 0 0 0 8 5 0 
0 0 0 X 0 0 0 0 2 0 7 4 0 X 6 7 3 3 5 7 0 4 X 0 X X X X 0 X 5 0 X 5 6 0 0 0 6 X 0 3 0 0 8 7 0 0 
2 X 0 X X 0 X 0 6 5 0 0 X X 0 X 5 7 0 0 4 7 4 X X 0 0 7 X X 0 3 0 2 6 0 X 0 X 0 4 0 X 0 0 3 0 X 
X X 8 X X 0 X 4 X 0 0 0 3 0 0 7 0 X 2 X 2 2 7 0 0 0 0 3 0 X X 0 0 X X X 0 X 3 0 X 8 0 4 2 X 6 3 
X 0 0 X X 0 6 3 5 X 0 0 0 0 7 0 2 6 X 0 3 2 X 2 0 0 7 3 0 4 8 X 0 3 2 X 0 X 0 X X 0 4 8 0 7 0 4 
0 0 X X X 8 7 0 X X 5 0 0 0 0 0 4 5 3 5 0 2 7 8 0 0 0 0 0 X X 8 0 0 8 4 0 0 3 0 7 0 0 0 5 3 0 X 
0 0 0 0 X 3 3 X X 0 5 2 8 0 X 0 4 4 0 X 0 0 7 X 0 0 6 0 0 0 0 0 0 5 2 2 0 X 6 0 7 8 7 0 4 7 0 0 
X 0 X 7 X X 0 0 0 0 0 7 0 0 6 X 0 2 X 7 6 0 0 4 0 X X 6 0 5 4 0 0 0 0 4 X X 3 X 4 6 0 0 0 5 0 0 
0 0 3 X 0 6 0 X 4 0 0 3 5 0 3 5 X 0 0 5 0 X 0 6 7 4 6 0 4 7 7 2 X 7 8 0 X 0 0 X 0 0 0 8 5 0 X 0 
8 X 0 2 6 X 0 3 6 X X 0 6 5 0 4 2 2 2 0 0 6 3 X 3 X 8 X X 0 X 6 3 0 0 0 X 4 7 X 7 3 0 2 0 8 0 6 
0 0 0 5 7 8 X 0 0 4 7 0 0 0 0 8 0 2 2 4 0 5 0 8 5 2 X 4 0 5 7 X 3 5 0 X 0 2 0 7 3 0 5 5 X X 0 5 
0 0 6 0 X 3 0 6 6 8 4 4 0 5 7 4 X 0 X 0 X 5 2 3 0 0 0 8 5 2 6 0 2 0 0 0 5 4 0 5 X 2 4 3 X X 0 0 
X 0 X 3 8 X 3 0 0 7 X 0 0 6 8 2 0 6 4 0 X 2 2 0 0 X 0 5 2 8 0 0 0 0 8 X X 7 2 7 4 7 2 0 X 4 0 X 