6 5
S 4 0 6 0
6 X 0 X 4
0 X 7 X 0
5 0 0 X 8
0 0 X 0 0
0 0 0 0 P